1111111111111
1P000C00000E1
1001111011001
1G0010000C0C1
1100000110001
1C0G000010001
1111111111111
