111111111111111
1P000C000001G01
111011111100001
1C0000000000001
1E0000000C00001
111111111111111
