1111111111111111111
1PC000000001G0010C1
1011000000011111001
101100111100C0000E1
1000C01G00000000001
1111111111111111111
