111111111111
1P00C000G001
100111101101
1C0E0000C0C1
1G0011111001
1C0000000001
111111111111
