1111111
1P0G0C1
1001101
1C000E1
1111111
