111111111111111111111111111
1P0000000C0000000000C0000E1
100111101100011000000100001
1C0010000C0000100000C000001
110000011000001000000110001
1C00000010000000000000C0001
1000000C0000C00000111000001
111100000111110000000C00001
10000000C00000000C000000001
110000000000110000111000001
100000000C0000C000000C00001
100010000001100000110000001
1100000110000G0000000000001
10000000100000000001100C001
1000C000000000000000000G001
111111111111111111111111111
