111111
1P0C11
1110E1
111111