111111
1P0E11
111111
111C11
111111
